wood="wood",
forest="wood",
scrub="scrub",
heath="heath",
wetland="wetland",
beach="beach",
sand="sand",
farmland="farmland",
farm="farmland",
orchard="farmland",
vineyard="farmland",
plant_nursery="farmland",
glacier="ice",
ice_shelf="ice",
grassland="grassland",
grass="grass",
meadow="meadow",
allotments="allotments",
park="park",
village_green="village_green",
recreation_ground="recreation_ground",
garden="garden",
golf_course="golf_course",
fell = "fell",
moor = "moor",
shrubbery = "shrubbery",
tree = "tree",
tree_row = "tree_row",
tundra = "tundra",
mud = "mud",
shingle = "shingle",
water = "water",
bare_rock = "bare_rock",
blockfield = "blockfield",
cliff = "cliff",
dune = "dune",
rock = "rock",
scree = "scree",
sinkhole = "sinkhole",
stone = "stone",
salt_pond = "salt_pond",
cemetery = "cemetery",
landfill = "landfill",
quarry = "quarry",
railway = "railway",
recreation_ground = "recreation_ground",
village_green = "village_green",
greenery = "greenery",
pitch = "pitch",
stadium = "stadium",
swimming_pool = "swimming_pool",
track = "track",
cutline = "cutline",
apron = "apron",
hangar = "hangar",
helipad = "helipad",
heliport = "heliport",
terminal = "terminal",
hedge = "hedge",
commercial = "commercial",
industrial = "industrial",
residential = "residential",
retail = "retail",
basin = "basin"